111111111111111
10000P000000001
1E0000000C00001
100000000000001
10P000000000001
111111111111111
