11111
10C01
10001
11E11
10P01
11111
