111111111
1000E0011
100000001
111C00001
1C00000E1
111111111

