11111111111111
1000E001100111
10000000001111
111C0000000C01
1C000001111111
11100000C00001
10000000000001
11111111111111

