1111111111111
0000CEP000000
1111111111111