111111111111
10000000C001
1000E0000001
1000P0000001
100C00000001
100000000001
111111111111
