111111111111111
100P00C000000E1
111111111111111
