11111
1C001
100C1
11E11
11P11
11111
