11111111111111111
11000000000PC1111
1E000000Abd000001
10000000000000001
11111111111111111
