11101111
10000001
10000001
1C00P001
1000E001
11111111
