1111111111111111111111111111111111111111111111111111
1000000000000000000000000000000000000000000000000001
100000000000000000000000000000P000000001000000000001
1C00000000000000000000000000000000000001000000000001
10000000000000000000C0000000000000000001000000000001
111111110000000000000000000000000C000001000000000001
10000000000000000011110000000000000C0001000000000001
1000000000011111110000000000000000000001000000000001
1000000000000000000000000000000000000001000000000001
1000000000000000000000000000000000000001000000000001
1000000000000000000000000011110000000001000000000001
100000000000000000000000000000000000C001000000000001
10000000000CC000000000000000000000000001000000000001
1111111100000000000000000111110000000001000000000001
10000000000000000000C0000000000000000001000000000001
1000000000000000000000000000000000000001000000000001
1000000000000000000000000000000001111111000000000001
1000000000000000000000000000000C00000001000000000001
1000000000000000000000000000000000000001000000000001
1000000000111111111100000000000000000001000000000001
1000000000000000000000000000000000000001000000000001
1000000000000000000000000000000000000E01000000000001
1110111111111111111111111111111111111111000000000001
1000000000000000000000000000000000000000000000000001
1000000000000000000000000000000000000000000000000001
1000000000000000000000000000000000000000000000000001
1000000000000000000000000000000000000000000000000001
1000000000000000000000000000000000000000000000000001
1000000000000000000000000000000000000000000000000001
1000000000000000000000000000000000000000000000000001
1111111111111111111111111111111111111111111111111111
