1111111111111111111111111111111111
10010000000000C10010000000000000C0
1000000000010001000000000011100000
1000000000000000000000000000000000
1000000000000000000000000000000000
1000000000000000000000000000000000
1000000000000000000000000000000000
1000000000000000000000000000000000
1000000C10000000000011111110100000
1000000000000001000100000000000000
1000000000000001000100000000000000
100000000P00000001000000000000000C
1000000000000001000100000000000000
1000000E00000001000100000000000000
10010000000000C10010000000000000C1
1000000000011101000000000011100000
100001011111C100000011111110100000
1000110000000001000100000000000000
1111111111111111111111111111111111