111111111111111
100000P11000001
1C1000000000001
111111E10001111
111111111111111
