111110111
111000P11
10000C111
100000001
100000001
1E0000111
111111111

