1111111111111
11 C     P  1
1          E1
1111111111111
