1111111111111
110000PCE1111
110 000 00001
1111111111111
