11111111111111111111111
10000000000000000P00001
100000C000C000000000011
111111C1000000000000001
10000000000000011111111
1C0000000000000000C0001
1E000000000000000000111
11111111111111111111111
1000000000000C000000011
100000000000000000C0001
1000000CC00000000000001
10000000000000000000001
11111111111111111111111
