11111111111111111111111111111111111111
10E00000000000000000000CCCCCCCCCCCC001
100000000000000000000000CCCCCCCCCC0001
1000000000000000000000000CCCCCCCC00001
10000000000000000000000000CCCCCC000001
100000000000000000000000000CCCC0000001
1000000000000000000000000000CC00000001
10000000000000000000000000000000000001
11111111111111100011111111111111111111
10000000000000000000000000000000000001
10000000000000000000000000000000000001
10000000000000000000000000000000000001
10000000000000000000000000000000000001
10000000000000000000000000000000000001
10000000000000000000000000000000000001
10000000000000000000000000000000000001
10000000000000000000000000000000000001
100000000000000000000000000000000000P1
11111111111111111111111111111111111111
